-2 -2 -2 9 9 9 9 9 9 9 9 9 9 9 9 9 9 9 9 9 9 9 9
-2 -2 -2 9 0 0 0 0 0 0 0 0 0 0 0 0 0 0 0 0 0 0 9
-2 -2 -2 9 0 0 0 0 0 0 0 7 0 0 0 0 0 0 3 0 0 0 9
-2 -2 -2 9 0 0 0 3 0 0 0 0 90 0 2 0 0 0 0 0 0 0 9
-2 -2 -2 9 0 0 0 0 0 0 0 0 0 0 0 0 0 0 0 7 0 0 9
-2 -2 -2 9 0 0 0 0 0 0 0 12 13 0 0 0 0 0 0 0 0 0 9
-2 -2 -2 9 0 0 0 0 0 0 0 0 0 0 0 0 0 0 0 0 0 0 9
-2 -2 -2 9 0 0 2 0 0 -1 -1 -1 -1 -1 -1 -1 -1 0 0 0 2 0 9
-2 -2 -2 9 0 0 0 0 0 0 0 0 0 0 0 0 0 0 0 0 0 0 9
-2 -2 -2 9 0 0 0 0 0 0 0 0 13 12 0 0 0 0 0 0 0 0 9
-2 -2 -2 9 0 0 0 0 7 0 0 0 0 0 0 0 0 0 0 3 0 0 9
-2 -2 -2 9 0 0 0 0 0 0 0 0 0 0 0 0 0 0 0 0 0 0 9
-2 -2 -2 9 0 0 3 0 0 0 0 0 0 0 2 0 0 0 0 7 0 0 9
-2 -2 -2 9 0 0 0 0 0 0 0 0 0 0 0 0 0 0 0 0 0 0 9
-2 -2 -2 9 9 9 9 9 9 9 9 0 0 0 0 9 9 9 9 9 9 9 9
-2 -2 -2 -2 -2 -2 -2 -2 -2 -2 9 1 1 1 1 9 -2 -2 -2 -2 -2 -2 -2
-2 -2 -2 -2 -2 -2 -2 -2 -2 -1 -1 0 0 0 0 -1 -1 -2 -2 -2 -2 -2 -2
-2 -2 -2 -2 -2 -2 -2 -2 -2 -1 0 0 0 0 0 0 -1 -2 6 6 6 6 6 6 6 6 6 6 6 6
-2 -2 -2 -2 -2 -2 -2 -2 -2 -1 0 0 0 0 0 0 -1 -2 6 0 0 0 0 0 0 0 0 0 90 6
-2 -2 -2 -2 -2 -2 -2 -2 -2 -1 0 0 0 0 0 0 -1 -2 6 0 8 8 8 0 0 8 8 8 0 6
-2 -2 -2 -2 -2 -2 -2 -2 -2 -1 0 0 0 0 0 0 -1 -2 6 0 0 0 0 0 0 0 0 0 0 6
-2 -2 -2 -2 -2 -2 -2 -2 -2 -1 0 0 0 0 0 0 -1 -2 6 0 8 8 8 0 0 8 8 8 0 6
-2 -2 -2 -2 -2 -2 -2 -2 -2 -1 0 0 0 0 0 0 0 1 0 0 0 0 0 0 0 0 0 0 0 6
-2 -2 -2 -2 -2 -2 -2 -2 -2 -1 0 0 0 0 0 0 0 1 0 0 0 0 0 0 0 0 0 0 0 6
-2 -2 -2 -2 -2 -2 -2 -2 -2 -1 0 0 0 0 0 0 -1 -2 6 0 8 8 8 0 0 8 8 8 0 6
5 5 5 5 5 5 5 5 -2 -1 0 0 0 0 0 0 -1 -2 6 0 0 0 0 0 0 0 0 0 0 6
5 90 2 0 0 0 7 5 -2 -1 0 0 0 0 0 0 -1 -2 6 0 8 8 8 0 0 8 8 8 0 6
5 0 0 0 0 0 0 5 -2 -1 0 0 0 0 0 0 -1 -2 6 0 0 0 0 0 0 0 0 0 90 6
5 0 0 4 4 0 0 0 1 0 0 0 0 0 0 0 -1 -2 6 6 6 6 6 6 6 6 6 6 6 6
5 0 0 4 4 0 0 0 1 0 0 0 0 0 0 0 -1 -2 -2 -2 -2 -2 -2 -2 -2 -2 -2 -2 -2 -2
5 0 0 0 2 0 0 5 -2 -1 0 0 0 0 0 0 -1 -2 -2 -2 -2 -2 -2 -2 -2 -2 -2 -2 -2 -2
5 90 7 0 0 0 0 5 -2 -1 0 0 0 0 0 0 -1 -2 -1 -1 -1 -1 -1 -1 -1 -1
5 5 5 5 5 5 5 5 -2 -1 0 0 0 0 0 0 -1 -2 -1 0 0 0 0 0 90 -1
-2 -2 -2 -2 -2 -2 -2 -2 -2 -1 0 0 0 0 0 0 -1 -2 -1 0 0 0 0 3 0 -1
-2 -2 -2 -2 -2 -2 -2 -2 -2 -1 0 0 0 0 0 0 -1 -1 -1 0 3 0 0 0 0 -1
-2 -2 -2 -2 -2 -2 -2 -2 -2 -1 0 0 0 0 0 0 0 1 0 0 0 0 0 0 0 -1
-2 -2 -2 -2 -2 -2 -2 -2 -2 -1 0 0 0 0 0 0 0 1 0 0 2 0 3 0 0 -1
-2 -2 -2 -2 -2 -2 -2 -2 -2 -1 0 0 0 0 0 0 -1 -1 -1 0 0 0 0 0 0 -1
-2 -2 -2 -2 -2 -2 -2 -2 -2 -1 0 0 0 0 0 0 -1 -2 -1 0 3 0 0 2 0 -1
-2 -2 -2 -2 -2 -2 -2 -2 -2 -1 0 0 0 0 0 0 -1 -2 -1 0 0 0 0 0 90 -1
-2 -2 -2 -2 -2 -2 -2 -2 -2 -1 0 0 0 0 0 0 -1 -2 -1 -1 -1 -1 -1 -1 -1 -1
-2 -2 -2 -2 -2 -2 -2 -2 -2 -1 0 0 0 0 0 0 -1 -2 -2 -2 -2 -2 -2 -2 -2 -2 -2 -2 -2 -2
-2 -2 -2 -2 -2 -2 -2 -2 -1 0 0 0 0 0 0 0 0 -1 -2 -2 -2 -2 -2 -2 -2 -2 -2 -2 -2 -2
-2 -2 -2 -2 -2 -2 -2 -2 -1 0 0 0 0 0 0 0 0 -1 -2 -2 -2 -2 -2 -2 -2 -2 -2 -2 -2 -2
-2 -2 -2 -2 -2 -2 -2 -2 -1 0 0 0 0 0 0 0 0 -1 -2 -2 -2 -2 -2 -2 -2 -2 -2 -2 -2 -2
-2 -2 -2 -2 -2 -2 -2 -2 -1 0 0 0 0 0 0 0 0 -1 -2 -2 -2 -2 -2 -2 -2 -2 -2 -2 -2 -2
-2 -2 -2 -2 -2 -2 -2 -2 -1 0 0 0 0 80 0 0 0 -1 -2 -2 -2 -2 -2 -2 -2 -2 -2 -2 -2 -2
-2 -2 -2 -2 -2 -2 -2 -2 -1 -1 -1 -1 -1 -1 -1 -1 -1 -1 -2 -2 -2 -2 -2 -2 -2 -2 -2 -2 -2 -2